<ROUTINE SAILOR-FCN ()
	  <COND (<VERB? TELL>
		 <SETG P-CONT <>>
		 <SETG QUOTE-FLAG <>>
		 <TELL "You can't talk to the sailor that way." CR>)
		(<VERB? EXAMINE>
		 %<COND (<==? ,ZORK-NUMBER 3>
			 '<COND (<NOT <FSET? ,VIKING-SHIP ,INVISIBLE>>
				 <TELL
"He looks like a sailor." CR>
				 <RTRUE>)>)
			(ELSE T)>
		 <TELL
"There is no sailor to be seen." CR>)
		(<VERB? HELLO>
		 <SETG HS <+ ,HS 1>>
		 %<COND (<==? ,ZORK-NUMBER 3>
			 '<COND (<NOT <FSET? ,VIKING-SHIP ,INVISIBLE>>
		                 <TELL
"The seaman looks up and maneuvers the boat toward shore. He cries out \"I
have waited three ages for someone to say those words and save me from
sailing this endless ocean. Please accept this gift. You may find it
useful!\" He throws something which falls near you in the sand, then sails
off toward the west, singing a lively, but somewhat uncouth, sailor song." CR>
		                 <FSET ,VIKING-SHIP ,INVISIBLE>
		                 <MOVE ,VIAL ,HERE>)
		                (<==? ,HERE ,FLATHEAD-OCEAN>
		                 <COND (,SHIP-GONE
			                <TELL "Nothing happens anymore." CR>)
			               (T
				        <TELL "Nothing happens yet." CR>)>)
				(T <TELL "Nothing happens here." CR>)>)
			(T
			 '<COND (<0? <MOD ,HS 20>>
				 <TELL
"You seem to be repeating yourself." CR>)
				(<0? <MOD ,HS 10>>
				 <TELL
"I think that phrase is getting a bit worn out." CR>)
				(T
				 <TELL "Nothing happens here." CR>)>)>)>>